XXXXXXXXXXX


                           XXXXXXXXXXXXXXXXXXXX
                           										X
      XXX
      																				X
      																				X
      																				X
      																XXXXXXXXX


XXXXXXXXXXXXXXXXXX







      XXXXXXXXXXXXX                           X
      																				X
XXXXXXXXXXXXXXXXXXXX     XXXXXXXXXXXXXXXXXXXXXX
X
X
X
X
XXXXXXXXXXXXXXXXXXXXXXXXXXXXXXXXXXXXXXX